0x00000000 0x08000000 0x00000000 0 0
0xF5000000 0xF6000000 0x00000000 1 0
0xAF000000 0xAFF00000 0x00000000 2 0
0xA8000000 0xA9000000 0x00000000 3 0
0xF0000000 0xF1000000 0x00000000 4 0
0xAA000000 0xAB000000 0x00000000 5 0
0xA4000000 0xA5000000 0x00000000 6 0
0xF4000000 0xF5000000 0x00000000 7 0
