0x00000000 0x08000000 0x00000000 0 0
0xF5000000 0xF6000000 0x00000000 1 0
0xAF000000 0xB0000000 0x00000000 2 0
0xA8000000 0xA9000000 0x00000000 3 0
0xC0000000 0xC0000040 0x00000000 4 0
0xC5000000 0xC5100000 0x00000000 5 0
0xC1000000 0xC1000010 0x00000000 6 0
0xC1000010 0xC1000020 0x00000000 7 0
0xC1000020 0xC1000030 0x00000000 8 0
0xC1000030 0xC1000040 0x00000000 9 0
